###########
##o  F    #
#    #  o #
# #C #    #
#  oC o  ##
#  #  o   #
# # M  o  #
#        o#
#C      #o#
##    C o #
#  #    o #
#Z    #oC #
# # Zo  oC#
#o#  #   S#
# C  ZZ   #
#CC Z  ## #
#  o  C o #
###########
